#####
#..G#
#...#
#S..#
#####
